1111111111111
10PCEO00000110
1111111111111


