11111111111111111111111
10C1000P0000000000000E10
11111111111111111111111