11111111111
1OOOOOOOOO1
1OOOOOOECP1
11111111111