11111111111111111111111
10100010111011100101111
1000000P000000000001111
10111010111110010111011
11111110111010100001011
10001110111101000011011
11101110100010010111011
1000C00C101010000O000E1
10010011000011000000001
1110O000100C00001111001
11111111111111111111111